....................
...GB...........X...
...--.BG.......--...
...BG.--........G...
...--..........--...
...GB....BG....G....
...--....--....--...
...BG...........G...
...--.......BG.--...
...GB.......--.G....
...--..........--...
...BG...........G...
...--..........--...
.1..................
####################
